Primer
An Interactive Fiction by Daniel Chávez
Release 1 / Serial number 160306 / Inform 7 build 6M62 (I6/v6.33 lib 6/12N) SD

Middle of Nowhere
The tire tracks from the south stop abruptly here, but where the hell are you? The desert sand and clumps of pale sagebrush are all your dimming headlights pick out before barely reaching a concrete building to the north.

Your poor old pickup truck ticks and groans, smashed gracelessly against a tall Saguaro; whiffs of evaporating gasoline linger in the chill air.

>north
Crumbling Concrete

* * *

Primer
An Interactive Fiction by Daniel Chávez
Release 1 / Serial number 160306 / Inform 7 build 6M62 (I6/v6.33 lib 6/12N) SD

Middle of Nowhere
The tire tracks from the south stop abruptly here, but where the hell are you? The desert sand and clumps of pale sagebrush are all your dimming headlights pick out before barely reaching a concrete building to the north.

Your poor old pickup truck ticks and groans, smashed gracelessly against a tall Saguaro; whiffs of evaporating gasoline linger in the chill air.

>n
Crumbling Concrete
The building is nondescript. The windows include a pane of cracked glass, a dust-covered window and a tiny frosted window.

>m
That's not a verb I recognise.

>n
Base of the Tower
You can see a tumbleweed and a rusty can here.

>take tin
You can't see any such thing.

>take can
Taken.

>drop can
Dropped.

>take rusty
Taken.

>i
You are carrying:
  a rusty can

* * *

>n
Crumbling Concrete
The building is nondescript. The windows include a pane of cracked glass, a dust-covered window and a tiny frosted window.

>in
Staging Area

>n
Foreman's Office
You can see a half-collapsed desk (on which is a rusted key) here.

>take table
You can't see any such thing.

>take desk
Taken.

>i
You are carrying:
  a half-collapsed desk
    a rusted key
  a pack of cigarettes
  a lighter
  a denim jacket (being worn)

>drop desk
Dropped.

>x
What do you want to examine?

>l
Foreman's Office
You can see a half-collapsed desk (on which is a rusted key) here.

>take key
Taken.

>i
You are carrying:
  a rusted key
  a pack of cigarettes
  a lighter
  a denim jacket (being worn)

* * *

>n
Crumbling Concrete
The building is nondescript. The windows include a pane of cracked glass, a dust-covered window and a tiny frosted window.

>n
Base of the Tower
Behind the building a steel girder rises from the sand, one of three legs of the huge electrical tower looming like some gargantuan spider into blackness above you. A tumbleweed drifts lazily against the rusted metal among scrawny weeds and bits of trash. The desert stretches in all directions except back south towards the building.

You can see a rusty can here.

>s
Crumbling Concrete

>in
Staging Area

* * *

>n
Foreman's Office
You can see a half-collapsed desk (on which is a rusted key) here.

>n
You can't go that way.

>s
Staging Area

>e
Break Room
You can see a wire mesh cage (closed) here.

>open cage
You open the wire mesh cage, revealing an emergency blanket.

>get blanket
Taken.

* * *

>s
Crumbling Concrete

>s
Middle of Nowhere
You can see a tall Saguaro here.

* * *

>n
Base of the Tower
Behind the building a steel girder rises from the sand, one of three legs of the huge electrical tower looming like some gargantuan spider into blackness above you. A tumbleweed drifts lazily against the rusted metal among scrawny weeds and bits of trash. The desert stretches in all directions except back south towards the building.

You can see a rusty can here.

>x girder
You can't see any such thing.

* * *

>n
Base of the Tower
Behind the building a steel girder rises from the sand, one of three legs of the huge electrical tower looming like some gargantuan spider into blackness above you. A tumbleweed drifts lazily against the rusted metal among scrawny weeds and bits of trash. The desert stretches in all directions except back south towards the building.

You can see a rusty can here.

>take tumbleweed
That's hardly portable.

* * *

>n
Base of the Tower
Behind the building a steel girder rises from the sand, one of three legs of the huge electrical tower looming like some gargantuan spider into blackness above you. A tumbleweed drifts lazily against the rusted metal among scrawny weeds and bits of trash. The desert stretches in all directions except back south towards the building.

You can see a rusty can here.

>n
Against the Fence
You can see a large, rusty fence. It surrounds the tower vicinity as if involving it. Even if old, it seems sturdy, and it's imposing size and spiky ends tell you it wouldn't be wise trying to climb it.

>x fence
You look in awe at the giant fence. It's rust and wear tells you of the many years it has standed against the merciless desert and won, so far, at least. It curves towards you, part menacely, as if warning you to not try to climb it, part reassuringly, as if telling you you are safe within it.

* * *

Primer
An Interactive Fiction by Daniel Chávez
Release 1 / Serial number 160306 / Inform 7 build 6M62 (I6/v6.33 lib 6/12N) SD

Middle of Nowhere
The tire tracks from the south stop abruptly here, but where the hell are you? The desert sand and clumps of pale sagebrush are all your dimming headlights pick out before barely reaching a concrete building to the north.

Your poor old pickup truck ticks and groans, smashed gracelessly against a tall Saguaro; whiffs of evaporating gasoline linger in the chill air.

>x
(the tall Saguaro)
You see nothing special about the tall Saguaro.

>s
Backtracking

>n
Middle of Nowhere
You can see a tall Saguaro here.

>n
Crumbling Concrete

>n
Base of the Tower
You can see a tumbleweed and a rusty can here.

>s
Crumbling Concrete

>sw
You can't go that way.

>s
Middle of Nowhere
You can see a tall Saguaro here.

>w
You can't go that way.

>e
You can't go that way.

>se
You can't go that way.

>ne
You can't go that way.

>nw
You can't go that way.

>nw
You can't go that way.

>ne
You can't go that way.

>n
Crumbling Concrete

>e
Weed-strewn Rust

>l
Weed-strewn Rust

>x
What do you want to examine?

>x yellowing
You see nothing special about the yellowing weeds.

>x weeds
You see nothing special about the yellowing weeds.

>take weeds
They're fixed in place.

* * *

Primer
An Interactive Fiction by Daniel Chávez
Release 1 / Serial number 160306 / Inform 7 build 6M62 (I6/v6.33 lib 6/12N) SD

Middle of Nowhere
The tire tracks from the south stop abruptly here, but where the hell are you? The desert sand and clumps of pale sagebrush are all your dimming headlights pick out before barely reaching a concrete building to the north.

Your poor old pickup truck ticks and groans, smashed gracelessly against a tall Saguaro; whiffs of evaporating gasoline linger in the chill air.

>take cactus
That's fixed in place.

>n
Crumbling Concrete

* * *

>n
Base of the Tower
You can see a tumbleweed and a rusty can here.

>e
You can't go that way.

>s
Crumbling Concrete

>e
Weed-strewn Rust

>take weed
You can't see any such thing.

>take weeds
They're fixed in place.

* * *

Primer
An Interactive Fiction by Daniel Chávez
Release 1 / Serial number 160306 / Inform 7 build 6M62 (I6/v6.33 lib 6/12N) SD

Middle of Nowhere
The tire tracks from the south stop abruptly here, but where the hell are you? The desert sand and clumps of pale sagebrush are all your dimming headlights pick out before barely reaching a concrete building to the north.

Your poor old pickup truck ticks and groans, smashed gracelessly against a tall Saguaro; whiffs of evaporating gasoline linger in the chill air.

>i
You are carrying:
  a pack of cigarettes
  a lighter
  a denim jacket (being worn)

* * *

Primer
An Interactive Fiction by Daniel Chávez
Release 1 / Serial number 160306 / Inform 7 build 6M62 (I6/v6.33 lib 6/12N) SD

Middle of Nowhere
The tire tracks from the south stop abruptly here, but where the hell are you? The desert sand and clumps of pale sagebrush are all your dimming headlights pick out before barely reaching a concrete building to the north.

Your poor old pickup truck ticks and groans, smashed gracelessly against a tall Saguaro; whiffs of evaporating gasoline linger in the chill air.

>tree
compass (589730) 
  the north
  the northeast
  the northwest
  the south
  the southeast
  the southwest
  the east
  the west
  the up
  the down
  the inside
  the outside
(darkness object) (589762) 
(Inform Parser) (589794) 
(Inform Library) (589826) 
(property_numberspace_forcer) (589858) 
(ValuePropertyHolder_43) (589922) 
(ValuePropertyHolder_47) (589954) 
last day of school (591138) 
Staying the night (591170) 
canned oranges (591202) 
roll of duct tape (591234) 
gas can (591266) 
Fixing the truck (591298) 
Middle of Nowhere (591330) 
  yourself
    a pack of cigarettes
    a lighter
    a denim jacket (being worn)
  a tall Saguaro
  a withered cactus
Backtracking (591426) 
Crumbling Concrete (591458) 
Base of the Tower (591490) 
  a tumbleweed
  a rusty can
  a huge electrical tower
Weed-strewn Rust (591618) 
  some yellowing weeds
Roof (591682) 
Staging Area (591714) 
  a pane of cracked glass
Foreman's Office (591778) 
  a half-collapsed desk
    a rusted key
  a dust-covered window
Break Room (591906) 
  a wire mesh cage (closed)
    an emergency blanket
  a tiny frosted window
Storage Room (592034) 
Tower Vicinity (592066) 
  Around the Tower
  Office Interior
Brake Room (592162) 
  some scattered newspapers

>tree Break Room
Break Room (591906) 
  a wire mesh cage (closed)
    an emergency blanket
  a tiny frosted window

I beg your pardon?

I beg your pardon?

>showme
Middle of Nowhere - room
    yourself - person
        pack of cigarettes
        lighter
        denim jacket (worn)
    tall Saguaro
    withered cactus - plant

>showme tumbleweed
tumbleweed - plant
location: in Base of the Tower
singular-named, improper-named; unlit, inedible, portable; alive
list grouping key: none
printed name: "tumbleweed"
printed plural name: "plants"
indefinite article: none
description: none
initial appearance: none

>relations
Suggestion relates various things to one memory:
  The tumbleweed  >=>  the last day of school
Requirement relates one plan to various things:
  Staying the night  >=>  the canned oranges
  Staying the night  >=>  the emergency blanket
  Fixing the truck  >=>  the roll of duct tape
  Fixing the truck  >=>  the gas can

* * *

Primer
An Interactive Fiction by Daniel Chávez
Release 1 / Serial number 160306 / Inform 7 build 6M62 (I6/v6.33 lib 6/12N) SD

Middle of Nowhere
The tire tracks from the south stop abruptly here, but where the hell are you? The desert sand and clumps of pale sagebrush are all your dimming headlights pick out before barely reaching a concrete building to the north.

Your poor old pickup truck ticks and groans, smashed gracelessly against a tall Saguaro; whiffs of evaporating gasoline linger in the chill air.

>take headlights
Those seem to be a part of the pickup truck.

* * *

Primer
An Interactive Fiction by Daniel Chávez
Release 1 / Serial number 160306 / Inform 7 build 6M62 (I6/v6.33 lib 6/12N) SD

Middle of Nowhere
The tire tracks from the south stop abruptly here, but where the hell are you? The desert sand and clumps of pale sagebrush are all your dimming headlights pick out before barely reaching a concrete building to the north.

Your poor old pickup truck ticks and groans, smashed gracelessly against a tall Saguaro; whiffs of evaporating gasoline linger in the chill air.

>look pickup truck
The pickup truck is empty.

>x truck
The pickup truck is empty.